1111111111111
1P010000000C1
1111111111111
100011E000001
1111111111111